11D1D1D1D1D1D1D1D1D1D1D1
D0000000000000000000000D
10000000000W00000000001D
D00000000000000000000001
10000000000000000000001D
1D1D1D1D1D1D1D1D1D1D1D11