1111111111111D1111111111
100000000000010000000001
100000000S000D00000000D
100000000000010000000001
111111111111111111111111

