11111D11111D111111111111
D0000000000000000000000D
10000000000S000000000011
D00000000000000000000001
10000000000000000000001D
111D11111111111111D11111
